1111111111111
10010000000C1
10000111110C1
1P011E0C00011
1111111111111
1111111111111
1111111111111
1111111111111
1111111111111
1111111111111
1111111111111
1111111111111